XXXXXXXXXXXXXXXXXXX
X   BDX 1DX 2 X 2BX
XXXBXXXBXXXBXXXXXBX
X       X   B   XBX
X XXXXX X XXXBX XBX
X B  0X X X XBX XBX
XXXXXBXBX X XBX XBX
X B  0X 1 X XDX   X
X XXXXXXXXX XXXXXBX
X BBBBBBB X B  0XBX
XXXXXXXXX X XXXXXBX
X       B X X2  XBX
XBXXXBXXXXX XXX XBX
XBXDX X     BDX XBX
XBX X X X XXXXX XBX
XBX B X X XD  B XDX
XBXXX X X XXXXXBXXX
XD 2X 2 X B      1X
XXXXXXXXXXXXXXXXXXX



